Lisa, how will I ever forget her slushy little arms, her cute smile. It's just a distant memory now. I barely even knew Amy. It's all crumbling down, piece by piece as I try to hold it all together. I though it would be a new start. After Lisa, Amy was all I had.

Please press SPACE to continue.

>go through Hotel Door
Map
You take out your cellphone and open the gps. These are the locations you can see: 
 1) Police Station towards north. 
 1) Your Hotel towards south.

>n
Police Station
YOU ENTER THE POLICE STATION: The police station stands as a monolith structure in the middle of nowhere. The walls seem tall and threatning, with almost no signs of windows the place seemed to look like a fortress. You see the path TOWARDS THE NORTH that leads to the hallway behind the front desk.

You can see a Receptionist here.

>talk to Receptionist
You think of quesitons you could ask Receptionist. There are the only things you could think of: 1). Who are you.
2). What do you do.
3). Can i meet the Chief Inspector.

>ask receptionist about who are you
I am the receptionist at Haridwar Police Station. How may i help you today?

* * *

>talk to Receptionist
You think of quesitons you could ask Receptionist. There are the only things you could think of: 1). Who are you.
2). What do you do.
3). Can i meet the Chief Inspector.

>s
Map
You take out your cellphone and open the gps. These are the locations you can see: 
 1) Police Station towards north. 
 1) Your Hotel towards south.

>s
Hotel Room
A beautiful, well lit room with an attached bathroom.

Old ass table.

You can also see Television, Painting, Ceiling lights, Bed and a Hotel Door here.

>n
Police Station
The police station stands as a monolith structure in the middle of nowhere. The walls seem tall and threatning, with almost no signs of windows the place seemed to look like a fortress.

You can see a Receptionist here.

* * *

>s
Hotel Room
A beautiful, well lit room with an attached bathroom.

Old ass table.

You can also see Television, Painting, Ceiling lights, Bed and a Hotel Door here.

>go through Hotel Door
Map
boo

* * *

>s
Map
You take out your cellphone and open the gps. These are the locations you can see: 
 1) Police Station towards north. 
 1) Your Hotel towards south.

>n
Police Station
The police station stands as a monolith structure in the middle of nowhere. The walls seem tall and threatning, with almost no signs of windows the place seemed to look like a fortress.

You can see a Receptionist and Inspector's Office's Door here.

>talk to Receptionist
You think of the questions you need to ask. You can only think of these: 
 1.Who are you? 
 2.What do you do? 
 3.Can I meet the Cheif Inspector?

* * *

>talk to Receptionist
You think of quesitons you could ask Receptionist. There are the only things you could think of: 1). Who are you.
2). What do you do.
3). Can i meet the Chief Inspector.

>ask Recpetionist about Can i meet the Cheif Inspector
You can't see any such thing.

>ask Recpetionist about Can i meet the Cheif Inspector?
You can't see any such thing.

>ask Recptionist about Can i meet the Cheif Inspector?
You can't see any such thing.

* * *

>ask Receptionist about what do you do
I answer visitor's questions.

>ask Receptionist about can i meet the chief inspector
The Chief Inspector is busy today, you should come back later.

>ask Receptionist about can i meet the chief inspector
The Chief Inspector is busy today, you should come back later.

>go through Inspector's Office's Door
The Receptionist stops you from going through the door: I'm sorry the Inspector is busy. Please come back later.

>talk to receptionist
You think of the questions you need to ask. You can only think of these: 
 1.Who are you? 
 2.What do you do? 
 3.Can I meet the Cheif Inspector? 
 Its really important, can i please meet the inspector?

* * *

>ask Receptionist about Receptionist_a
Ehh, I already said he's busy,but if you're willing to help me out, i might look into it.

* * *

>talk to Receptionist
You think of quesitons you could ask Receptionist. There are the only things you could think of: 1). Who are you.
2). What do you do.
3). Can i meet the Chief Inspector.

>ask Receptionist about Who are you
Glulxe fatal error: Memory access out of range (-67FF7ECC)

* * *

>talk to Receptionist
You think of quesitons you could ask Receptionist. There are the only things you could think of: 1). Who are you.
2). What do you do.
3). Can i meet the Chief Inspector.

>ask Receptionist about Can i meet the Chief inspector
The Chief Inspector is busy today, you should come back later.

>talk to Receptionist
Who are you.
What do you do.
Can i meet the Chief Inspector.

>talk to Receptionist
Who are you.
What do you do.
Can i meet the Chief Inspector.

* * *

>talk to Receptionist
You think of quesitons you could ask Receptionist. There are the only things you could think of: 1). Who are you.
2). What do you do.
3). Can i meet the Chief Inspector.

>talk to Receptionist
1). Who are you.
2). What do you do.
3). Can i meet the Chief Inspector.
4). Its really important can i please meet the innspector.

* * *

>talk to Receptionist
You think of quesitons you could ask Receptionist. There are the only things you could think of: 1). Who are you.
2). What do you do.
3). Can i meet the Chief Inspector.

>ask Who are you
You can't see any such thing.

>ask Receptionist Who are you
I didn't understand that sentence.

>ask Receptionist about Who are you
I am the receptionist at  this Police Station. How may i help you today?

>give Receptionist money
You can't see any such thing.

* * *

>n
Police Station
YOU ENTER THE POLICE STATION: The police station stands as a monolith structure in the middle of nowhere. The walls seem tall and threatning, with almost no signs of windows the place seemed to look like a fortress. You see the path TOWARDS THE NORTH that leads to the hallway behind the front desk.

You can see a Receptionist here.

>talk to receptionist
You think of quesitons you could ask Receptionist. There are the only things you could think of 
 1). Who are you.
You think of quesitons you could ask Receptionist. There are the only things you could think of 
 2). What do you do.
You think of quesitons you could ask Receptionist. There are the only things you could think of 
 3). Can i meet the Chief Inspector.

>ask Receptionist about Can i meet the cheif Inspector
The Cheif Inspector is busy today, you should come back later.

* * *

>talk to receptionist
You think of quesitons you could ask Receptionist. There are the only things you could think of 
 1). Who are you.
You think of quesitons you could ask Receptionist. There are the only things you could think of 
 2). What do you do.
You think of quesitons you could ask Receptionist. There are the only things you could think of 
 3). Can i meet the Chief Inspector.

>talk to receptionist
Who are you.
What do you do.
Can i meet the Chief Inspector.
Its really important can i please meet the innspector.

* * *

>n
Police Station
YOU ENTER THE POLICE STATION: The police station stands as a monolith structure in the middle of nowhere. The walls seem tall and threatning, with almost no signs of windows the place seemed to look like a fortress. You see the path TOWARDS THE NORTH that leads to the hallway behind the front desk.

You can see a Receptionist here.

>go through Inspector's Office's Door
The Receptionist stops you from going through the door: I'm sorry the Inspector is busy. Please come back later.

>inventory
You are carrying nothing.

* * *

>n
Police Station
YOU ENTER THE POLICE STATION: The police station stands as a monolith structure in the middle of nowhere. The walls seem tall and threatning, with almost no signs of windows the place seemed to look like a fortress. You see the path TOWARDS THE NORTH that leads to the hallway behind the front desk.

You can see a Receptionist here.

>s
Map
You take out your cellphone and open the gps. These are the locations you can see: 
 1) Police Station towards north. 
 1) Your Hotel towards south.

* * *

>n
Police Station
YOU ENTER THE POLICE STATION: The police station stands as a monolith structure in the middle of nowhere. The walls seem tall and threatning, with almost no signs of windows the place seemed to look like a fortress. You see the path TOWARDS THE NORTH that leads to the hallway behind the front desk.

You can see a Receptionist here.

>give money to receptionist
You can't see any such thing.

>give money to Receptionist
You can't see any such thing.

>give some money to Receptionist
You can't see any such thing.

* * *

>n
Police Station
YOU ENTER THE POLICE STATION: The police station stands as a monolith structure in the middle of nowhere. The walls seem tall and threatning, with almost no signs of windows the place seemed to look like a fortress. You see the path TOWARDS THE NORTH that leads to the hallway behind the front desk.

You can see a Receptionist here.

>go through inspector's office's foor
You can't see any such thing.

>go through inspector's office's
The Receptionist stops you from going through the door: I'm sorry the Inspector is busy. Please come back later.

>talk to receptionist
You think of quesitons you could ask Receptionist. These are the only things you could think of: 
1). Who are you.
2). What do you do.
3). Can i meet the Chief Inspector.

>s
Map
You take out your cellphone and open the gps. These are the locations you can see: 
 1) Police Station towards north. 
 1) Your Hotel towards south.

>s
Hotel Room
A beautiful, well lit room with an attached bathroom.

You can see Dresser (on which are some money), Television, Table, Painting, Ceiling lights, Bed and a Hotel Door here.

>take money
Taken.

>n
Bathroom
A boring bathroom.

>s
Hotel Room
A beautiful, well lit room with an attached bathroom.

You can see Dresser, Television, Table, Painting, Ceiling lights, Bed and a Hotel Door here.

>n
Bathroom
A boring bathroom.

* * *

>s
Hotel Room
A beautiful, well lit room with an attached bathroom.

You can see Dresser, Television, Table, Painting, Ceiling lights, Bed and a Hotel Door here.

>s
Map
You take out your cellphone and open the gps. These are the locations you can see: 
 1) Police Station towards north. 
 1) Your Hotel towards south.

>n
Police Station
YOU ENTER THE POLICE STATION: The police station stands as a monolith structure in the middle of nowhere. The walls seem tall and threatning, with almost no signs of windows the place seemed to look like a fortress.

You can see Inspector's Office's Door and a Receptionist here.

>give some money to Receptionist
The wight recoils, appalled.

* * *

>n
Police Station
YOU ENTER THE POLICE STATION: The police station stands as a monolith structure in the middle of nowhere. The walls seem tall and threatning, with almost no signs of windows the place seemed to look like a fortress. You see the path TOWARDS THE NORTH that leads to the hallway behind the front desk.

You can see a Receptionist here.

>n
The Receptionist stops you from going through the door: Im sorry only authorised personell are allowed in there.

>give some money to Receptionist
You can't see any such thing.

>s
Map
You take out your cellphone and open the gps. These are the locations you can see: 
 1) Police Station towards north. 
 1) Your Hotel towards south.

>n
Police Station
YOU ENTER THE POLICE STATION: The police station stands as a monolith structure in the middle of nowhere. The walls seem tall and threatning, with almost no signs of windows the place seemed to look like a fortress. You see the path TOWARDS THE NORTH that leads to the hallway behind the front desk.

You can see a Receptionist here.

>give some money to receptionist
The Receptionist recoils, appalled, but accepts the bribe and makes a weird gesture towards the hallway.

>n
hallway
You can see Softboard (in which is notes), Evidence Locker Room Door and Inspectors Office Door here.

>go through Inspectors office door
Inspector's Office
The inspectors office is right outside a jail cell, the fresh yet wraught smell of the bricks is quite prominent in this part of the police station. The only light attached to the ceiling give the room an odd and ominous look.

You can see Madhava here.

* * *

>n
Police Station
YOU ENTER THE POLICE STATION: The police station stands as a monolith structure in the middle of nowhere. The walls seem tall and threatning, with almost no signs of windows the place seemed to look like a fortress. You see the path TOWARDS THE NORTH that leads to the hallway behind the front desk.

You can see a Receptionist here.

>give some money to Receptionist
You can't see any such thing.

* * *

>take money
Taken.

>go through Door
Map
You take out your cellphone and open the gps. These are the locations you can see: 
 1) Police Station towards north. 
 1) Your Hotel towards south.

>n
Police Station
YOU ENTER THE POLICE STATION: The police station stands as a monolith structure in the middle of nowhere. The walls seem tall and threatning, with almost no signs of windows the place seemed to look like a fortress. You see the path TOWARDS THE NORTH that leads to the hallway behind the front desk.

You can see a Receptionist here.

>give some money to Receptionist
The Receptionist recoils, appalled, but accepts the bribe and makes a weird gesture towards the hallway.

>n
hallway
You can see Softboard (in which is notes), Evidence Locker Room Door and Inspectors Office Door here.

>go to evidence locker room
You can't see any such thing.

>go through Evidence door
I should probably not go in there without permission

>n
Inspector's Office
The inspectors office is right outside a jail cell, the fresh yet wraught smell of the bricks is quite prominent in this part of the police station. The only light attached to the ceiling give the room an odd and ominous look.

You can see an inspector here.

>s
You can't go that way.

* * *

>go through Hotel Door
Map
You take out your cellphone and open the gps. These are the locations you can see: 
 1) Police Station towards north. 
 1) Your Hotel towards south.

>go n
Police Station
The police station stands as a monolith structure in the middle of nowhere. The walls seem tall and threatning, with almost no signs of windows the place seemed to look like a fortress.

You can see a Receptionist here.

>talk to Receptionist
You think of the questions you need to ask. 
 1.Who are you?

* * *

>go through Hotel Door
Map
You take out your cellphone and open the gps. These are the locations you can see: 
 1) Police Station towards north. 
 1) Your Hotel towards south.

>s
Hotel Room
A beautiful, well lit room with an attached bathroom.

Old ass table.

You can also see Television, Painting, Ceiling lights, Bed and a Hotel Door here.

>go through Hotel Door
Map
V

>n
Police Station
The police station stands as a monolith structure in the middle of nowhere. The walls seem tall and threatning, with almost no signs of windows the place seemed to look like a fortress.

You can see a Receptionist here.

>talk to Receptionist
You think of the questions you need to ask. You can only think of these: 
 1.Who are you? 
 2.What do you do? 
 3.Can I meet the Cheif Inspector?

>s
Map
V

>s
Hotel Room
A beautiful, well lit room with an attached bathroom.

Old ass table.

You can also see Television, Painting, Ceiling lights, Bed and a Hotel Door here.

>go though Hotel Door
You can't see any such thing.

>go through Hotel Door
Map
V

* * *

Lisa, how will I ever forget her slushy little arms, her cute smile. It's just a distant memory now. I barely even knew Amy. It's all crumbling down, piece by piece as I try to hold it all together. I though it would be a new start. After Lisa, Amy was all I had.

Please press SPACE to continue.

>go through Hotel Dor
You can't see any such thing.

>go through Hotel Door
You take out your cellphone and open the gps. These are the locations you can see: 
 1) Police Station towards north.

>n
Police Station
The police station stands as a monolith structure in the middle of nowhere. The walls seem tall and threatning, with almost no signs of windows the place seemed to look like a fortress.

You can see a Receptionist here.

* * *

>ask Receptionist about who are you
I am the receptionist at  this Police Station. How may i help you today?

>ask Receptionist about can i meet the cheif inspector
The Cheif Inspector is busy today, you should come back later.

>think
What a good idea.

>thinking
That's not a verb I recognise.

>think
What a good idea.

>s
Map
You see these destinations on the map.

* * *

Lisa, how will I ever forget her slushy little arms, her cute smile. It's just a distant memory now. I barely even knew Amy. It's all crumbling down, piece by piece as I try to hold it all together. I though it would be a new start. After Lisa, Amy was all I had.

Please press SPACE to continue.

>go through Hotel Dooe
You can't see any such thing.

>go through Hotel Door
You take out your cellphone and open the gps. These are the locations you can see: 
 1) Police Station towards north. 
 1) Your Hotel towards south.

>s
You can't go that way.

* * *

Lisa, how will I ever forget her slushy little arms, her cute smile. It's just a distant memory now. I barely even knew Amy. It's all crumbling down, piece by piece as I try to hold it all together. I though it would be a new start. After Lisa, Amy was all I had.

Please press SPACE to continue.

>inventory
You are carrying nothing.

>take money
Taken.

>inventory
You are carrying:
  some money

>s
Map
You take out your cellphone and open the gps. These are the locations you can see: 
 1) Police Station towards north. 
 1) Your Hotel towards south.

* * *

>n
Police Station
YOU ENTER THE POLICE STATION: The police station stands as a monolith structure in the middle of nowhere. The walls seem tall and threatning, with almost no signs of windows the place seemed to look like a fortress. You see the path TOWARDS THE NORTH that leads to the hallway behind the front desk.

You can see a Receptionist here.

>give money to Recpetionist
You can't see any such thing.

>give money to Recepetionist
You can't see any such thing.

>give money to Receptionist
The Receptionist recoils, appalled, but accepts the bribe and makes a weird gesture towards the hallway.

>n
hallway
You can see Softboard (in which is notes), Evidence Locker Room Door, Inspectors Office Door and a guard here.

>go through Inspectors Office
Inspector's Office
The inspectors office is right outside a jail cell, the fresh yet wraught smell of the bricks is quite prominent in this part of the police station. The only light attached to the ceiling give the room an odd and ominous look.

You can see an inspector here.

>talk to inspector
You think of quesitons you could ask inspector. These are the only things you could think of: 
1). Hi How are you.

You think of quesitons you could ask inspector. These are the only things you could think of: 
1). Who are you.

* * *

>ask inspector about Did you find anything new about Tim
Yes, thank you for coming over, I called you because we just foudn out that your friend Tim is not the only person missing, there appears to be a link in all the people missing but we cannot figure out what the link is. The only thing we know is that 3 tourists from the USA have been kidnaped in the past 2 months around New Delhi Area and one has been murdered.

>talk to inspector
You think of quesitons you could ask inspector. These are the only things you could think of: 
1). Hi How are you.

You think of quesitons you could ask inspector. These are the only things you could think of: 
1). Who are you.

>talk to inspector
You think of quesitons you could ask inspector. These are the only things you could think of: 
1). Hi How are you.

You think of quesitons you could ask inspector. These are the only things you could think of: 
1). Who are you.

* * *

>talk to inspector
You think of quesitons you could ask inspector. These are the only things you could think of: 
1). Hi How are you.

You think of quesitons you could ask inspector. These are the only things you could think of: 
1). Who are you.

* * *

>inventory
You are carrying nothing.

>eat mushroom
(first taking the magic shrinking mushroom)
You eat the mushroom, and almost immediately feel yourself shrinking. You also suddenly have a handkerchief.

* * *

Lisa, how will I ever forget her slushy little arms, her cute smile. It's just a distant memory now. I barely even knew Amy. It's all crumbling down, piece by piece as I try to hold it all together. I though it would be a new start. After Lisa, Amy was all I had.

Please press SPACE to continue.

>think
What a good idea.

>thinking
You must supply a noun.

* * *

Lisa, how will I ever forget her slushy little arms, her cute smile. It's just a distant memory now. I barely even knew Amy. It's all crumbling down, piece by piece as I try to hold it all together. I though it would be a new start. After Lisa, Amy was all I had.

Please press SPACE to continue.

>thinking
What a good idea.

* * *

Lisa, how will I ever forget her slushy little arms, her cute smile. It's just a distant memory now. I barely even knew Amy. It's all crumbling down, piece by piece as I try to hold it all together. I though it would be a new start. After Lisa, Amy was all I had.

Please press SPACE to continue.

>boo
You must supply a noun.

* * *

Lisa, how will I ever forget her slushy little arms, her cute smile. It's just a distant memory now. I barely even knew Amy. It's all crumbling down, piece by piece as I try to hold it all together. I though it would be a new start. After Lisa, Amy was all I had.

Please press SPACE to continue.

>x Hotel Door
This door leads outside the Hotel.

>go thorugh hotel door
You can't see any such thing.

* * *

Lisa, how will I ever forget her slushy little arms, her cute smile. It's just a distant memory now. I barely even knew Amy. It's all crumbling down, piece by piece as I try to hold it all together. I though it would be a new start. After Lisa, Amy was all I had.

Please press SPACE to continue.

>x dresser
A wallet and a laptop rests atop a dresser.

On Dresser are some money.

>take some money
Taken.

>inventory
You are carrying:
  some money

>x
(the money)
You see nothing special about the money.

>go through hotel door
Map
You take out your cellphone and open the gps. These are the locations you can see: 
 1) Police Station towards north. 
 1) Your Hotel towards south.

>n
Police Station
YOU ENTER THE POLICE STATION: The police station stands as a monolith structure in the middle of nowhere. The walls seem tall and threatning, with almost no signs of windows the place seemed to look like a fortress.

You can see Inspector's Office's Door and a Receptionist here.

>talk to receptionist
You think of quesitons you could ask Receptionist. These are the only things you could think of: 1). Who are you.
2). What do you do.
3). Can i meet the Chief Inspector.

* * *

Lisa, how will I ever forget her slushy little arms, her cute smile. It's just a distant memory now. I barely even knew Amy. It's all crumbling down, piece by piece as I try to hold it all together. I though it would be a new start. After Lisa, Amy was all I had.

Please press SPACE to continue.

>take some money
Taken.

>go through Hotel Door
Map
You take out your cellphone and open the gps. These are the locations you can see: 
 1) Police Station towards north. 
 1) Your Hotel towards south.

>s
Hotel Room
A beautiful, well lit room with an attached bathroom.

You can see Dresser, Television, Table, Painting, Ceiling lights, Bed and a Hotel Door here.

>go through Hotel Door
Map
You take out your cellphone and open the gps. These are the locations you can see: 
 1) Police Station towards north. 
 1) Your Hotel towards south.

>n
Police Station
YOU ENTER THE POLICE STATION: The police station stands as a monolith structure in the middle of nowhere. The walls seem tall and threatning, with almost no signs of windows the place seemed to look like a fortress.

You can see Inspector's Office's Door and a Receptionist here.

>talk to Receptionist
You think of quesitons you could ask Receptionist. These are the only things you could think of: 
1). Who are you.
2). What do you do.
3). Can i meet the Chief Inspector.

>ask receptionist about who are you
I am the receptionist at  this Police Station. How may i help you today?

>ask receptionist about can i meet the chief inspector
The Chief Inspector is busy today, you should come back later.

>ask receptionsit about what do you do
I answer visitor's questions.

>go to inspector's office
You can't see any such thing.

>go to Inspector's office
You can't see any such thing.

>n
Inspector's Office
The inspectors office is right outside a jail cell, the fresh yet wraught smell of the bricks is quite prominent in this part of the police station. The only light attached to the ceiling give the room an odd and ominous look.

You can see Madhava here.

* * *

Lisa, how will I ever forget her slushy little arms, her cute smile. It's just a distant memory now. I barely even knew Amy. It's all crumbling down, piece by piece as I try to hold it all together. I though it would be a new start. After Lisa, Amy was all I had.

Please press SPACE to continue.

>take money
Taken.

>go through hotel door
Map
You take out your cellphone and open the gps. These are the locations you can see: 
 1) Police Station towards north. 
 1) Your Hotel towards south.

* * *

>n
Police Station
YOU ENTER THE POLICE STATION: The police station stands as a monolith structure in the middle of nowhere. The walls seem tall and threatning, with almost no signs of windows the place seemed to look like a fortress.

You can see Inspector's Office's Door and a Receptionist here.

>n
The Receptionist stops you from going through the door: I'm sorry the Inspector is busy. Please come back later.

>talk to receptionist
You think of quesitons you could ask Receptionist. These are the only things you could think of: 
1). Who are you.
2). What do you do.
3). Can i meet the Chief Inspector.

>talk to receptionist
You think of quesitons you could ask Receptionist. These are the only things you could think of: 
1). Who are you.
2). What do you do.
3). Can i meet the Chief Inspector.
4). Its really important can i please meet the Inspector.

* * *

>ask receptionist about Its really important can i please meet the inspector
Ehh, I already said he's busy, how about some mutual help? If only it had something for me in it

>ask receptionist about Its really important can i please meet the inspector
Ehh, I already said he's busy, how about some mutual help? If only it had something for me in it

>inventory
You are carrying:
  some money

>give some money to Receptionist
The Receptionist doesn't seem interested.

* * *

Lisa, how will I ever forget her slushy little arms, her cute smile. It's just a distant memory now. I barely even knew Amy. It's all crumbling down, piece by piece as I try to hold it all together. I though it would be a new start. After Lisa, Amy was all I had.

Please press SPACE to continue.

>take some moeny
You can't see any such thing.

>take some money
Taken.

* * *

>talk to receptionist
You think of quesitons you could ask Receptionist. These are the only things you could think of: 
1). Who are you.
2). What do you do.
3). Can i meet the Chief Inspector.
4). Its really important can i please meet the Inspector.

>give money to receptionist
The wight recoils, appalled.

>inventory
You are carrying nothing.

* * *

>n
Police Station
YOU ENTER THE POLICE STATION: The police station stands as a monolith structure in the middle of nowhere. The walls seem tall and threatning, with almost no signs of windows the place seemed to look like a fortress.

You can see Inspector's Office's Door and a Receptionist here.

>give money to receptionist
The Receptionist recoils, appalled, but accepts the bribe and makes a weird gesture towards the door.

>n
Inspector's Office
The inspectors office is right outside a jail cell, the fresh yet wraught smell of the bricks is quite prominent in this part of the police station. The only light attached to the ceiling give the room an odd and ominous look.

You can see Softboard (in which is notes) and Madhava here.

* * *

>take money
Taken.

>s
Map
You take out your cellphone and open the gps. These are the locations you can see: 
 1) Police Station towards north. 
 1) Your Hotel towards south.

* * *

>n
The Receptionist stops you from going through the door: Im sorry only authorised personell are allowed in there.

>n
The Receptionist stops you from going through the door: Im sorry only authorised personell are allowed in there.

>talk to Receptionist
You think of quesitons you could ask Receptionist. These are the only things you could think of: 
1). Who are you.
2). What do you do.
3). Can i meet the Chief Inspector.

>talk to Receptionist
You think of quesitons you could ask Receptionist. These are the only things you could think of: 
1). Who are you.
2). What do you do.
3). Can i meet the Chief Inspector.
4). Its really important can i please meet the Inspector.

* * *

>ask receptionist about Its really important can i please meet the Inspector
Ehh, I already said he's busy, how about some mutual help? If only it had something for me in it

>give some money to receptionist
The Receptionist recoils, appalled, but accepts the bribe and makes a weird gesture towards the hallway.

* * *

>n
hallway
You can see Softboard (in which is notes), Evidence Locker Room Door and Inspectors Office Door here.

>go through Inspectors Office Door
Inspector's Office
The inspectors office is right outside a jail cell, the fresh yet wraught smell of the bricks is quite prominent in this part of the police station. The only light attached to the ceiling give the room an odd and ominous look.

You can see an inspector here.

>talk to inspector
You think of quesitons you could ask inspector. These are the only things you could think of: 
1). Who are you.
2). What do you do.
3). Can i meet the Chief Inspector.
4). Its really important can i please meet the Inspector.

>talk to inspector
You think of quesitons you could ask inspector. These are the only things you could think of: 
1). Who are you.
2). What do you do.
3). Can i meet the Chief Inspector.
4). Its really important can i please meet the Inspector.

* * *

>n
The Receptionist stops you from going through the door: Im sorry only authorised personell are allowed in there.

>give money to receptionist
The Receptionist recoils, appalled, but accepts the bribe and makes a weird gesture towards the hallway.

>n
hallway
You can see Softboard (in which is notes), Evidence Locker Room Door, Inspectors Office Door and a guard here.

>talk to guard
I dont think he's in the mood to talk to random people. Better leave him alone.

>ask guard about how are you?
I dont think he's in the mood to talk to random people. Better leave him alone.

>talk to guard
I dont think he's in the mood to talk to random people. Better leave him alone.

>go through Evidence
The guard standing next to the door stops you from entering. I'm sorry you are not authorized to go inside.

* * *

>n
Police Station
YOU ENTER THE POLICE STATION: The police station stands as a monolith structure in the middle of nowhere. The walls seem tall and threatning, with almost no signs of windows the place seemed to look like a fortress. You see the path TOWARDS THE NORTH that leads to the hallway behind the front desk.

You can see a Receptionist here.

>talk to receptionist
You think of quesitons you could ask Receptionist. These are the only things you could think of: 
1). Who are you.
2). What do you do.
3). Can i meet the Chief Inspector.

>give money to receptionist
The Receptionist recoils, appalled, but accepts the bribe and makes a weird gesture towards the hallway.

* * *

>n
hallway
You can see Softboard (in which is notes), Evidence Locker Room Door, Inspectors Office Door and a guard here.

>go through Inspectors office door
Inspector's Office
The inspectors office is right outside a jail cell, the fresh yet wraught smell of the bricks is quite prominent in this part of the police station. The only light attached to the ceiling give the room an odd and ominous look.

You can see an inspector here.

>talk to inspector
You think of quesitons you could ask inspector. These are the only things you could think of: 
1). Hi How are you.
2). Did you find anything new about Tim.

>talk to inspector
You think of quesitons you could ask inspector. These are the only things you could think of: 
1). Hi How are you.
2). Did you find anything new about Tim.

* * *

>n
Police Station
YOU ENTER THE POLICE STATION: The police station stands as a monolith structure in the middle of nowhere. The walls seem tall and threatning, with almost no signs of windows the place seemed to look like a fortress. You see the path TOWARDS THE NORTH that leads to the hallway behind the front desk.

You can see a Receptionist here.

>give money to Receptionist
The Receptionist recoils, appalled, but accepts the bribe and makes a weird gesture towards the hallway.

* * *

>n
hallway
You can see Softboard (in which is notes), Evidence Locker Room Door, Inspectors Office Door and a guard here.

>go through Inspectors
Inspector's Office
The inspectors office is right outside a jail cell, the fresh yet wraught smell of the bricks is quite prominent in this part of the police station. The only light attached to the ceiling give the room an odd and ominous look.

You can see an inspector here.

>talk to inspector
You think of quesitons you could ask inspector. These are the only things you could think of: 
1). Hi How are you.
2). Did you find anything new about Tim.

>ask inspector about Did you find anything new about Tim
Yes, thank you for coming over, I called you because we just foudn out that your friend Tim is not the only person missing, there appears to be a link in all the people missing but we cannot figure out what the link is. The only thing we know is that 3 tourists from the USA have been kidnaped in the past 2 months around New Delhi Area and one has been murdered.

>talk to inspector
You think of quesitons you could ask inspector. These are the only things you could think of: 
1). Hi How are you.
2). Did you find anything new about Tim.

* * *

>ask inspector about Did you find anything new about Tim
Yes, thank you for coming over, I called you because we just foudn out that your friend Tim is not the only person missing, there appears to be a link in all the people missing but we cannot figure out what the link is. The only thing we know is that 3 tourists from the USA have been kidnaped in the past 2 months around New Delhi Area and one has been murdered.

>ask inspector about Did you find anything new about Tim
Yes, thank you for coming over, I called you because we just foudn out that your friend Tim is not the only person missing, there appears to be a link in all the people missing but we cannot figure out what the link is. The only thing we know is that 3 tourists from the USA have been kidnaped in the past 2 months around New Delhi Area and one has been murdered.

* * *

>n
Police Station
YOU ENTER THE POLICE STATION: The police station stands as a monolith structure in the middle of nowhere. The walls seem tall and threatning, with almost no signs of windows the place seemed to look like a fortress. You see the path TOWARDS THE NORTH that leads to the hallway behind the front desk.

You can see a Receptionist here.

>give monoey
You can't see any such thing.

>give money
(to the Receptionist)
The Receptionist recoils, appalled, but accepts the bribe and makes a weird gesture towards the hallway.

>n
hallway
You can see Softboard (in which is notes), Evidence Locker Room Door, Inspectors Office Door and a guard here.

* * *

>talk to inspector
You think of quesitons you could ask inspector. These are the only things you could think of: 
1). Hi How are you.
2). Did you find anything new about Tim.

>ask inspector about Did you find anything new about Tim
1). Hi How are you.
2). Do you know who the missing people are.

>talk to inspector
You think of quesitons you could ask inspector. These are the only things you could think of: 
1). Hi How are you.
2). Do you know who the missing people are.

* * *

>ask inspector about Hi How are you
I'm fine how are you

* * *

>n
Police Station
YOU ENTER THE POLICE STATION: The police station stands as a monolith structure in the middle of nowhere. The walls seem tall and threatning, with almost no signs of windows the place seemed to look like a fortress. You see the path TOWARDS THE NORTH that leads to the hallway behind the front desk.

You can see a Receptionist here.

>give money
(to the Receptionist)
The Receptionist recoils, appalled, but accepts the bribe and makes a weird gesture towards the hallway.

>n
hallway
You can see Softboard (on which is notes), Evidence Locker Room Door, Inspectors Office Door and a guard here.

>go through inspectors
Inspector's Office
The inspectors office is right outside a jail cell, the fresh yet wraught smell of the bricks is quite prominent in this part of the police station. The only light attached to the ceiling give the room an odd and ominous look.

You can see an inspector here.

>talk to inspector
You think of quesitons you could ask inspector. These are the only things you could think of: 
1). Hi How are you.
2). Did you find anything new about Tim.

* * *

>ask inspector about Did you find anything new about Tim
Yes, thank you for coming over, I called you because we just foudn out that your friend Tim is not the only person missing, there appears to be a link in all the people missing but we cannot figure out what the link is. The only thing we know is that 3 tourists from the USA have been kidnaped in the past 2 months around New Delhi Area and one has been murdered.

>talk to inspector
You think of quesitons you could ask inspector. These are the only things you could think of: 
1). Hi How are you.
2). Do you know who the missing people are.

>talk to inspector
You think of quesitons you could ask inspector. These are the only things you could think of: 
1). Hi How are you.
2). Do you know who the missing people are.

* * *

>ask inspector about Do you know who the missing people are
I dont remember the names of the missing people, but we have some idea of what is happened as we have stumbled upon some EVIDENCE. I will keep you i the loop about anything else that comes up.

>talk to inspector
You think of quesitons you could ask inspector. These are the only things you could think of: 
1). Hi How are you.
2). Do you know who the missing people are.

* * *

>s
hallway
You can see Softboard (on which is notes), Evidence Locker Room Door, Inspectors Office Door and a guard here.

>n
Inspector's Office
The inspectors office is right outside a jail cell, the fresh yet wraught smell of the bricks is quite prominent in this part of the police station. The only light attached to the ceiling give the room an odd and ominous look.

You can see an inspector here.

>e
You can't go that way.

>w
You can't go that way.

>x
(the inspector)
You see nothing special about the inspector.

>s
hallway
You can see Softboard (on which is notes), Evidence Locker Room Door, Inspectors Office Door and a guard here.

* * *

>n
Inspector's Office
The inspectors office is right outside a jail cell, the fresh yet wraught smell of the bricks is quite prominent in this part of the police station. The only light attached to the ceiling give the room an odd and ominous look.

You can see an inspector here.

>s
hallway
You can see Softboard (on which is notes), Evidence Locker Room Door, Inspectors Office Door and a guard here.

>go through evidence locker room dooe
You can't see any such thing.

>go through evidence locker room door
The guard standing next to the door stops you from entering. I'm sorry you are not authorized to go inside.

>go through evidence locker room door
The guard standing next to the door stops you from entering. I'm sorry you are not authorized to go inside.

>x softboard
There are several notes pinned to the softbaord, some contain notices signed by the chief inspector.

On Softboard is notes.

>x notes
Several notes are pinned onto the softboard

>take notes
You pretend to read the notes and sneakily take one of the notes signed by the inspector

>inventory
You are carrying:
  notes

>inventory
You are carrying:
  notes

>combine notes with sa
You can't see any such thing.

>x
(notes)
Several notes are pinned onto the softboard

>s
The guard standing next to the door stops you from entering. I'm sorry you are not authorized to go inside.

>n
Inspector's Office
The inspectors office is right outside a jail cell, the fresh yet wraught smell of the bricks is quite prominent in this part of the police station. The only light attached to the ceiling give the room an odd and ominous look.

You can see an inspector here.

>s
hallway
You can see Softboard, Evidence Locker Room Door, Inspectors Office Door and a guard here.

>s
The guard standing next to the door stops you from entering. I'm sorry you are not authorized to go inside.

>e
You can't go that way.

* * *

>w
You can't go that way.

>take softboard
That's fixed in place.

* * *

>s
Map
You take out your cellphone and open the gps. These are the locations you can see: 
 1) Police Station towards north. 
 1) Your Hotel towards south.

>s
Hotel Room
A beautiful, well lit room with an attached bathroom.

You can see Dresser, Television, Table, Painting, Ceiling lights, Bed and a Hotel Door here.

* * *

>n
hallway
You can see Softboard (in which is notes), Evidence Locker Room Door and Inspectors Office Door here.

>n
Inspector's Office
The inspectors office is right outside a jail cell, the fresh yet wraught smell of the bricks is quite prominent in this part of the police station. The only light attached to the ceiling give the room an odd and ominous look.

You can see an inspector here.

* * *

>s
You can't go that way.

>s
You can't go that way.

>n
You can't go that way.

>e
You can't go that way.

* * *

>take money
Taken.

>take table
Taken.

>combine money with table
you try to combine them. but THEY! DONT! GO! TOGETHER!

>combine money with table
you try to combine them. but THEY! DONT! GO! TOGETHER!

>combine table with money
Feeling a bit guilty you copy the signare on the note on to the evidence withdrawl form Table money

>n
Bathroom
A boring bathroom.

>s
Hotel Room
A beautiful, well lit room with an attached bathroom.

You can see Dresser, Television, Painting, Ceiling lights, Bed and a Hotel Door here.

>s
Map
You take out your cellphone and open the gps. These are the locations you can see: 
 1) Police Station towards north. 
 1) Your Hotel towards south.

* * *

>ask receptionist about Who are you
I am the receptionist at  this Police Station. How may i help you today?

>talk to receptionist
You think of quesitons you could ask Receptionist. These are the only things you could think of: 
1). Who are you.
2). What do you do.
3). Can i meet the Chief Inspector.
4). Its really important can i please meet the Inspector.

>s
Map
You take out your cellphone and open the gps. These are the locations you can see: 
 1) Police Station towards north. 
 1) Your Hotel towards south.

>s
Hotel Room
A beautiful, well lit room with an attached bathroom.

You can see Dresser, Television, Painting, Ceiling lights, Bed and a Hotel Door here.

>inventory
You are carrying:
  Table
  some money

>s
Map
You take out your cellphone and open the gps. These are the locations you can see: 
 1) Police Station towards north. 
 1) Your Hotel towards south.

* * *

>n
Police Station
YOU ENTER THE POLICE STATION: The police station stands as a monolith structure in the middle of nowhere. The walls seem tall and threatning, with almost no signs of windows the place seemed to look like a fortress. You see the path TOWARDS THE NORTH that leads to the hallway behind the front desk.

You can see a Receptionist here.

>give money to receptionist
The Receptionist recoils, appalled, but accepts the bribe and makes a weird gesture towards the hallway.

>n
hallway
You can see Softboard (on which is notes), Evidence Locker Room Door, Inspectors Office Door and a guard here.

>take notes
You pretend to read the notes and sneakily take one of the notes signed by the inspector

>go to inspectors office door
You can't see any such thing.

>go through inspector
Inspector's Office
The inspectors office is right outside a jail cell, the fresh yet wraught smell of the bricks is quite prominent in this part of the police station. The only light attached to the ceiling give the room an odd and ominous look.

You can see an inspector here.

>talk to inspector
You think of quesitons you could ask inspector. These are the only things you could think of: 
1). Hi How are you.
2). Did you find anything new about Tim.

>ask inspector about did you find anything new about Tim
Yes, thank you for coming over, I called you because we just foudn out that your friend Tim is not the only person missing, there appears to be a link in all the people missing but we cannot figure out what the link is. The only thing we know is that 3 tourists from the USA have been kidnaped in the past 2 months around New Delhi Area and one has been murdered.

>talk to inspector
You think of quesitons you could ask inspector. These are the only things you could think of: 
1). Hi How are you.
2). Do you know who the missing people are.

>ask inspector about Do you know who the missing people are
I dont remember the names of the missing people, but we have some idea of what is happened as we have stumbled upon some EVIDENCE. I will keep you i the loop about anything else that comes up.

* * *

>talk to inspector
You think of quesitons you could ask inspector. These are the only things you could think of: 
1). Hi How are you.
2). Do you know who the missing people are.

>s
hallway
You can see Softboard, Evidence Locker Room Door, Inspectors Office Door and a guard here.

>s
Police Station
YOU ENTER THE POLICE STATION: The police station stands as a monolith structure in the middle of nowhere. The walls seem tall and threatning, with almost no signs of windows the place seemed to look like a fortress. You see the path TOWARDS THE NORTH that leads to the hallway behind the front desk.

You can see a Receptionist here.

>x
What do you want to examine?

>x hallway
You can't see any such thing.

>s
Map
You take out your cellphone and open the gps. These are the locations you can see: 
 1) Police Station towards north. 
 1) Your Hotel towards south.

>e
You can't go that way.

* * *

>w
You can't go that way.

>s
Hotel Room
A beautiful, well lit room with an attached bathroom.

You can see Dresser, Television, Painting, Ceiling lights, Bed and a Hotel Door here.

* * *

>n
Police Station
YOU ENTER THE POLICE STATION: The police station stands as a monolith structure in the middle of nowhere. The walls seem tall and threatning, with almost no signs of windows the place seemed to look like a fortress. You see the path TOWARDS THE NORTH that leads to the hallway behind the front desk.

You can see a Receptionist here.

>n
hallway
You can see Softboard, Evidence Locker Room Door, Inspectors Office Door and a guard here.

>s
Police Station
YOU ENTER THE POLICE STATION: The police station stands as a monolith structure in the middle of nowhere. The walls seem tall and threatning, with almost no signs of windows the place seemed to look like a fortress. You see the path TOWARDS THE NORTH that leads to the hallway behind the front desk.

You can see a Receptionist here.

>talk to receptionsit
You think of quesitons you could ask Receptionist. These are the only things you could think of: 
1). Who are you.
2). What do you do.
3). Can i meet the Chief Inspector.
4). Its really important can i please meet the Inspector.

>ask receptionist about its really important can i please meet the inspector
Ehh, I already said he's busy, how about some mutual help? If only it had something for me in it

>talk to receptionsit
You think of quesitons you could ask Receptionist. These are the only things you could think of: 
1). Who are you.
2). What do you do.
3). Can i meet the Chief Inspector.
4). Its really important can i please meet the Inspector.

>ask receptionist about can i meet the chief inspector
The Chief Inspector is busy today, you should come back later.

>talk to receptionsit
You think of quesitons you could ask Receptionist. These are the only things you could think of: 
1). Who are you.
2). What do you do.
3). Can i meet the Chief Inspector.
4). Its really important can i please meet the Inspector.

>talk to receptionsit
You think of quesitons you could ask Receptionist. These are the only things you could think of: 
1). Who are you.
2). What do you do.
3). Can i meet the Chief Inspector.
4). Its really important can i please meet the Inspector.

>n
hallway
You can see Softboard, Evidence Locker Room Door, Inspectors Office Door and a guard here.

>n
Inspector's Office
The inspectors office is right outside a jail cell, the fresh yet wraught smell of the bricks is quite prominent in this part of the police station. The only light attached to the ceiling give the room an odd and ominous look.

You can see an inspector here.

>talk to inspector
You think of quesitons you could ask inspector. These are the only things you could think of: 
1). Hi How are you.
2). Do you know who the missing people are.

* * *

>ask inspector about do you know who the missing people are
I dont remember the names of the missing people, but we have some idea of what is happened as we have stumbled upon some EVIDENCE. I will keep you i the loop about anything else that comes up.

* * *

>s
hallway
You can see Softboard, Evidence Locker Room Door, Inspectors Office Door and a guard here.

* * *

>s
Police Station
YOU ENTER THE POLICE STATION: The police station stands as a monolith structure in the middle of nowhere. The walls seem tall and threatning, with almost no signs of windows the place seemed to look like a fortress. You see the path TOWARDS THE NORTH that leads to the hallway behind the front desk.

You can see a Receptionist here.

>talk to inspector
You can't see any such thing.

>talk to receptionsit
You think of quesitons you could ask Receptionist. These are the only things you could think of: 
1). Who are you.
2). What do you do.
3). Hello, is there a way i can get access to the evidence.
4). Boo.

* * *

>ask receptionist about who are you
I am the receptionist at  this Police Station. How may i help you today?

>ask receptionist about Who are you
I am the receptionist at  this Police Station. How may i help you today?

* * *

>talk to rceptionist
You can't see any such thing.

>talk to receptionist
You think of quesitons you could ask Receptionist. These are the only things you could think of: 
1). Who are you.
2). What do you do.
3). Can i meet the Chief Inspector.
4). Its really important can i please meet the Inspector.

* * *

>take money
Taken.

>invnetory
That's not a verb I recognise.

>inventory
You are carrying:
  some money

>n
Bathroom
A boring bathroom.

>s
Hotel Room
A beautiful, well lit room with an attached bathroom.

You can see a Hotel Door, Dresser, Television, Table (on which is Laptop), Painting, Ceiling lights and Bed here.

>s
Map
You take out your cellphone and open the gps. These are the locations you can see: 
 1) Police Station towards north. 
 1) Your Hotel towards south.

* * *

>give money
(to the Receptionist)
The Receptionist recoils, appalled, but accepts the bribe and makes a weird gesture towards the hallway.

>n
Hallway
You can see Inspectors Office Door, Softboard (on which is notes) and a guard here.

>n
Inspector's Office
The inspectors office is right outside a jail cell, the fresh yet wraught smell of the bricks is quite prominent in this part of the police station. The only light attached to the ceiling give the room an odd and ominous look.

You can see an inspector here.

>talk to
(the inspector)
You think of quesitons you could ask inspector. These are the only things you could think of: 
1). Hi How are you.
2). Did you find anything new about Tim.

>ask
(the inspector for the inspector)
(the inspector first taking the inspector)
The inspector has better things to do.

>ask inspector about Did you find anything new about Tim
Yes, thank you for coming over, I called you because we just foudn out that your friend Tim is not the only person missing, there appears to be a link in all the people missing but we cannot figure out what the link is. The only thing we know is that 3 tourists from the USA have been kidnaped in the past 2 months around New Delhi Area and one has been murdered.

>b
That's not a verb I recognise.

>talk to
(the inspector)
You think of quesitons you could ask inspector. These are the only things you could think of: 
1). Hi How are you.
2). Do you know who the missing people are.

>ask inspector about do you know who the missing people are
I dont remember the names of the missing people, but we have some idea of what is happened as we have stumbled upon some EVIDENCE. I will keep you i the loop about anything else that comes up.

>s
Hallway
You can see Inspectors Office Door, Softboard (on which is notes) and a guard here.

>s
Police Station
YOU ENTER THE POLICE STATION: The police station stands as a monolith structure in the middle of nowhere. The walls seem tall and threatning, with almost no signs of windows the place seemed to look like a fortress. You see the path TOWARDS THE NORTH that leads to the hallway behind the front desk.

You can see a Receptionist here.

>talk to receptionist
You think of quesitons you could ask Receptionist. These are the only things you could think of: 
1). Who are you.
2). What do you do.
3). Hello, is there a way i can get access to the evidence.
4). Boo.

>ask receptionist about Hello is there a way i can get access to the evidence
(the receptionist hands you an evidence retreival form)You need to get this evidence authentication form signed by the Chief Inspector.

>inventory
You are carrying:
  Evidence retrieval form

>ask receptionist about Hello is there a way i can get access to the evidence
(the receptionist hands you an evidence retreival form)You need to get this evidence authentication form signed by the Chief Inspector.

* * *

>inventory
You are carrying:
  Evidence retrieval form

>n
Hallway
You can see Inspectors Office Door, Softboard (on which is notes) and a guard here.

>take notes
You pretend to read the notes and sneakily take one of the notes signed by the inspector

>combine notes with form
Feeling a bit guilty you copy the signature on to the evidence form

>inventory
You are carrying:
  Signed evidence form
  notes

>n
Inspector's Office
The inspectors office is right outside a jail cell, the fresh yet wraught smell of the bricks is quite prominent in this part of the police station. The only light attached to the ceiling give the room an odd and ominous look.

You can see an inspector here.

>s
Hallway
You can see Inspectors Office Door, Softboard and a guard here.

>w
The guard unintrestingly sees the form and lets you in.

Evidence Locker Room
The walls in this room are painted white and hurt the eyes, it smells like bleach and other gross stuff.

You can see Locker Room Assistant here.

>talk
What do you want to talk to?

>talk to
What do you want to talk to?

>talk to Locker Room Assistant
You think of quesitons you could ask Locker Room Assistant. These are the only things you could think of: 
1). Who are you.
2). Evidence Retrieval.

* * *

>ask assistant about Evidence Retrieval
(The receptionist hands you case douments)Here is the  only evidence we have on this case.

>inventory
You are carrying:
  Case documents
  Signed evidence form
  notes

>x case documents
You see nothing special about Case documents.

You shuffle through the paperwork and find a list of missing people.

>x case documents
You see nothing special about Case documents.

You shuffle through the paperwork and find a list of missing people.

>examine case documents
You see nothing special about Case documents.

You shuffle through the paperwork and find a list of missing people.

>inventory
You are carrying:
  List of missing people
  Case documents
  Signed evidence form
  notes

* * *

>b
That's not a verb I recognise.

>inventory
You are carrying:
  List of missing people
  Case documents
  Signed evidence form
  notes

>s
You can't go that way.

* * *

>n
You can't go that way.

>e
Hallway
You can see Inspectors Office Door, Softboard and a guard here.

>w
The guard unintrestingly sees the form and lets you in.

Evidence Locker Room
The walls in this room are painted white and hurt the eyes, it smells like bleach and other gross stuff.

You can see Locker Room Assistant here.

>e
Hallway
You can see Inspectors Office Door, Softboard and a guard here.

* * *

>w
The guard unintrestingly sees the form and lets you in.

Evidence Locker Room
The walls in this room are painted white and hurt the eyes, it smells like bleach and other gross stuff.

You can see Locker Room Assistant here.

I beg your pardon?

>x
What do you want to examine?

>x room
You see nothing special about Locker Room Assistant.

>w
You can't go that way.

>s
You can't go that way.

>e
Hallway
You can see Inspectors Office Door, Softboard and a guard here.

>s
Police Station
YOU ENTER THE POLICE STATION: The police station stands as a monolith structure in the middle of nowhere. The walls seem tall and threatning, with almost no signs of windows the place seemed to look like a fortress. You see the path TOWARDS THE NORTH that leads to the hallway behind the front desk.

You can see a Receptionist here.

>s
Map
You take out your cellphone and open the gps. These are the locations you can see: 
 1) Police Station towards north. 
 1) Your Hotel towards south.

>s
Hotel Room
A beautiful, well lit room with an attached bathroom.

You can see a Hotel Door, Dresser, Television, Table (on which is Laptop), Painting, Ceiling lights and Bed here.

>use Laptop with List of missing people
I only understood you as far as wanting to use Laptop.

>combine Laptop with List of missing people
you look up the list of missing up online, after searching for a few hours you figure out that all of them were American students who came to India in the past 2 months.

>combine Laptop with List of missing people
you look up the list of missing up online, after searching for a few hours you figure out that all of them were American students who came to India in the past 2 months.

It will occasionally ask you to press the space bar, like that.

Welcome
An Interactive Fiction
Release 1 / Serial number 180908 / Inform 7 build 6M62 (I6/v6.33 lib 6/12N) SD

Hotel Room
A beautiful, well lit room with an attached bathroom.

You can see a Hotel Door, Dresser (on which are some money), Television, Table (on which is Laptop), Painting, Ceiling lights and Bed here.

* * *

Lisa, how will I ever forget her slushy little arms, her cute smile. It's just a distant memory now. I barely even knew Amy. It's all crumbling down, piece by piece as I try to hold it all together. I though it would be a new start. After Lisa, Amy was all I had.

Please press SPACE to continue.

>s
Map
You take out your cellphone and open the gps. These are the locations you can see: 
 1) Police Station towards north. 
 1) Your Hotel towards south.

* * *

>n
Police Station
YOU ENTER THE POLICE STATION: The police station stands as a monolith structure in the middle of nowhere. The walls seem tall and threatning, with almost no signs of windows the place seemed to look like a fortress. You see the path TOWARDS THE NORTH that leads to the hallway behind the front desk.

You can see a Receptionist here.

>talk to receptionist
You think of quesitons you could ask Receptionist. These are the only things you could think of: 
Glulxe fatal error: Memory access out of range (-3FF3FFFC)
1).

>s
Map
You take out your cellphone and open the gps. These are the locations you can see: 
 1) Police Station towards north. 
 1) Your Hotel towards south.

* * *

>give money to receptionist
The Receptionist recoils, appalled, but accepts the bribe and makes a weird gesture towards the hallway.

>n
hallway
You can see Softboard (in which is notes), Evidence Locker Room Door and Inspectors Office Door here.

>go to inspectors office
You can't see any such thing.

>go through inspectors office door
Inspector's Office
The inspectors office is right outside a jail cell, the fresh yet wraught smell of the bricks is quite prominent in this part of the police station. The only light attached to the ceiling give the room an odd and ominous look.

You can see an inspector here.

>talk to inspector
You think of quesitons you could ask inspector. These are the only things you could think of: 
1). Hi How are you.
2). Did you find anything new about Tim.

* * *

>n
hallway
You can see Softboard (on which is notes), Evidence Locker Room Door, Inspectors Office Door and a guard here.

>go to police station
You can't see any such thing.

>go through inspectors
Inspector's Office
The inspectors office is right outside a jail cell, the fresh yet wraught smell of the bricks is quite prominent in this part of the police station. The only light attached to the ceiling give the room an odd and ominous look.

You can see an inspector here.

>talk to
(the inspector)
You think of quesitons you could ask inspector. These are the only things you could think of: 
1). Hi How are you.
2). Did you find anything new about Tim.

>ask inspector about did you find anything new about tim
Yes, thank you for coming over, I called you because we just foudn out that your friend Tim is not the only person missing, there appears to be a link in all the people missing but we cannot figure out what the link is. The only thing we know is that 3 tourists from the USA have been kidnaped in the past 2 months around New Delhi Area and one has been murdered.

>talk to
(the inspector)
You think of quesitons you could ask inspector. These are the only things you could think of: 
1). Hi How are you.
2). Do you know who the missing people are.

>ask inspector about Do you know who the missing people are
I dont remember the names of the missing people, but we have some idea of what is happened as we have stumbled upon some EVIDENCE. I will keep you i the loop about anything else that comes up.

>talk to
(the inspector)
You think of quesitons you could ask inspector. These are the only things you could think of: 
1). Hi How are you.
2). Do you know who the missing people are.

>s
hallway
You can see Softboard (on which is notes), Evidence Locker Room Door, Inspectors Office Door and a guard here.

>s
Police Station
YOU ENTER THE POLICE STATION: The police station stands as a monolith structure in the middle of nowhere. The walls seem tall and threatning, with almost no signs of windows the place seemed to look like a fortress. You see the path TOWARDS THE NORTH that leads to the hallway behind the front desk.

You can see a Receptionist here.

* * *

>talk to receptionist
You think of quesitons you could ask Receptionist. These are the only things you could think of: 
1). Who are you.
2). What do you do.
3). Hello, is there a way i can get access to the evidence.
4). Boo.

>talk to receptionist
You think of quesitons you could ask Receptionist. These are the only things you could think of: 
1). Who are you.
2). What do you do.
3). Hello, is there a way i can get access to the evidence.
4). Boo.

>ask receptionist about Hello is there a way i can get access to the evidence
You need to get this evidence authentication form signed by the Chief Inspector.

>invnetory
That's not a verb I recognise.

>inventory
You are carrying nothing.

>ask receptionist about Hello is there a way i can get access to the evidence
You need to get this evidence authentication form signed by the Chief Inspector.

>inventory
You are carrying nothing.

* * *

Lisa, how will I ever forget her slushy little arms, her cute smile. It's just a distant memory now. I barely even knew Amy. It's all crumbling down, piece by piece as I try to hold it all together. I though it would be a new start. After Lisa, Amy was all I had.

Please press SPACE to continue.

>n
Bathroom
A boring bathroom.

>s
Hotel Room
A beautiful, well lit room with an attached bathroom.

You can see Dresser (on which are some money), Television, Table, Painting, Ceiling lights, Bed and a Hotel Door here.

>s
Map
You take out your cellphone and open the gps. These are the locations you can see: 
 1) Police Station towards north. 
 1) Your Hotel towards south.

* * *

Lisa, how will I ever forget her slushy little arms, her cute smile. It's just a distant memory now. I barely even knew Amy. It's all crumbling down, piece by piece as I try to hold it all together. I though it would be a new start. After Lisa, Amy was all I had.

Please press SPACE to continue.

THE RED TIRADE 
 By Aakarsh Sinha

Please press SPACE to continue.

>take money
You should probably not take that

>s
Map
You take out your cellphone and open the gps. These are the locations you can see: 
 1) Police Station towards north. 
 1) Your Hotel towards south.

* * *

>n
Police Station
YOU ENTER THE POLICE STATION: The police station stands as a monolith structure in the middle of nowhere. The walls seem tall and threatning, with almost no signs of windows the place seemed to look like a fortress. You see the path TOWARDS THE NORTH that leads to the hallway behind the front desk.

You can see a Receptionist here.

>give money to recepionist
You can't see any such thing.

>give money
You can't see any such thing.

>n
The Receptionist stops you from going through the door: Im sorry only authorised personell are allowed in there.

>take note
You can't see any such thing.

>take notes
You can't see any such thing.

>n
The Receptionist stops you from going through the door: Im sorry only authorised personell are allowed in there.

>talk to inspector
You can't see any such thing.

>ask inspector about Did you find anything new about Tim
You can't see any such thing.

I beg your pardon?

>talk to inspector
You can't see any such thing.

>ask inspector about Do you know who the missing people are
You can't see any such thing.

>s
Map
You take out your cellphone and open the gps. These are the locations you can see: 
 1) Police Station towards north. 
 1) Your Hotel towards south.

>w
American Embassy
A row of meagre light bulbs line the embassy. The seem as tired as the gloomy semi peeled paint that wanted to get off the walll. 
 (The guard at the gate makes you sign in you name address and some other personal information and lets you in)

You can see Help Desk Employee here.

>s
You can't go that way.

>talk to
(Help Desk Employee)
You think of quesitons you could ask Help Desk Employee. These are the only things you could think of: 
1). Who are you.
2). Can i talk to an Embassy Personnel.

>talk to receptionist
You can't see any such thing.

>ask receptionist about Hello is there a way i can get access to the evidenmce
You can't see any such thing.

>ask receptionist about Hello is there a way i can get access to the evidence
You can't see any such thing.

>inventory
You are carrying nothing.

>combine notes and evidence
You can't see any such thing.

>combine notes with evidence
You can't see any such thing.

>inventory
You are carrying nothing.

>n
Karl's office
You can see White Table (on which are Computer and Keyboard) and Karl here.

>w
You can't go that way.

>talk to
What do you want to talk to?

>talk
What do you want to talk to?

>talk to Locker
You can't see any such thing.

>ask Locker about Evidence Retrieval
You can't see any such thing.

>inventory
You are carrying nothing.

>x case documnets
You can't see any such thing.

>x case documents
You can't see any such thing.

>inventory
You are carrying nothing.

>s
American Embassy
A row of meagre light bulbs line the embassy. The seem as tired as the gloomy semi peeled paint that wanted to get off the walll. 
 (The guard at the gate makes you sign in you name address and some other personal information and lets you in)

You can see Help Desk Employee here.

>e
Map
You take out your cellphone and open the gps. These are the locations you can see: 
 1) Police Station towards north. 
 1) Your Hotel towards south.

>s
Hotel Room
A beautiful, well lit room with an attached bathroom.

You can see a Hotel Door, Dresser (on which are some money), Television, Table (on which is Laptop), Painting, Ceiling lights and Bed here.

>s
Map
You take out your cellphone and open the gps. These are the locations you can see: 
 1) Police Station towards north. 
 1) Your Hotel towards south.

>s
Hotel Room
A beautiful, well lit room with an attached bathroom.

You can see a Hotel Door, Dresser (on which are some money), Television, Table (on which is Laptop), Painting, Ceiling lights and Bed here.

>combine laptop with list of missing people
You can't see any such thing.

I beg your pardon?

I beg your pardon?

>n
Bathroom
A boring bathroom.

>s
Hotel Room
A beautiful, well lit room with an attached bathroom.

You can see a Hotel Door, Dresser (on which are some money), Television, Table (on which is Laptop), Painting, Ceiling lights and Bed here.

* * *

>w
American Embassy
A row of meagre light bulbs line the embassy. The seem as tired as the gloomy semi peeled paint that wanted to get off the walll. 
 (The guard at the gate makes you sign in you name address and some other personal information and lets you in)

You can see Help Desk Employee here.

>talk to Help Desk Employee
You think of quesitons you could ask Help Desk Employee. These are the only things you could think of: 
1). Who are you.
2). Can i talk to an Embassy Personnel.

>ask Help Desk Employee about Who are you
You see a man coming towards you,
 Hello, my name is Karl. i am an embassy personel how may i help you.

>talk to Karl
You think of quesitons you could ask Karl. These are the only things you could think of: 
1). Who are you.
2). Do you know something about the Kidnappings.

>talk to Karl
You think of quesitons you could ask Karl. These are the only things you could think of: 
1). Who are you.
2). Do you know something about the Kidnappings.

>ask Karl about do you know something about the Kidnappings
Lets talk about this in my office  (Karl leads you to his office.)

Karl's office
You can see White Table (on which are Computer and Keyboard) here.

>talk to Karl
You think of quesitons you could ask Karl. These are the only things you could think of: 
1). Who are you.
2). Do you know something about the Kidnappings.

>ask Karl about do you know something about the Kidnappings
Yes, i the police informed us about the kidnappings being US students, we are trying our best to assist the police in figuring out whats happening.

* * *

>talk to Karl
You think of quesitons you could ask Karl. These are the only things you could think of: 
1). Who are you.
2). You must have a list of all american citizens.

* * *

>ask Karl about Who are you
Im an embassy personnel.

>talk to Karl
You think of quesitons you could ask Karl. These are the only things you could think of: 
1). Who are you.
2). You must have a list of all american citizens.

>ask Karl about You must have a list of all american citizens
Im an embassy personnel.

* * *

>talk to Karl
You think of quesitons you could ask Karl. These are the only things you could think of: 
1). Who are you.
2). Please its a matter of life and death.

>x computer
You see nothing special about Computer.

>use Computer
It might be a bit rude to do that.

>ask Karl about Please its a matter of life and death
Karl gets a phone call, and without saying anything rushes out of the room, Your phone starts ringing too, you answer the call and find out that there has been a murder of another US citizen. Feeling a sudden chill and seeing the opprtunity you sit on Karl's chair and decide to USE THE COMPUTER to find out if you can find out more about this situaiton.

You can't reach into Unknown Place.

>use Computer
A red screen pops up when you move the mouse asking for password
 please enter the 4 digit password
Enter password:

>wf
wrong password, please try logging in the computer again.
That's not a verb I recognise.

>use Computer
A red screen pops up when you move the mouse asking for password
 please enter the 4 digit password
Enter password:

>1776
Using the computer you search and find out the list of US citizens who have eneter new delhi in the past 2 months. You begin to compare this list with the list of people who have been kidnapped or murdered and find out the out of all these people you are the only person remaining and are probably the next one on the list. This sends a shiver down your spine. You stand up and start to go out of Karl's office when he enters the room. 
 Karl tells you about the person who was murdered. and says you should not worry about anything that with the police help we will cathch the culprit soon.
That's not a verb I recognise.

>s
American Embassy
A row of meagre light bulbs line the embassy. The seem as tired as the gloomy semi peeled paint that wanted to get off the walll. 
 (The guard at the gate makes you sign in you name address and some other personal information and lets you in)

You can see Help Desk Employee here.

>s
You can't go that way.

>n
Karl's office
You can see Karl and White Table (on which are Computer and Keyboard) here.

>s
American Embassy
A row of meagre light bulbs line the embassy. The seem as tired as the gloomy semi peeled paint that wanted to get off the walll. 
 (The guard at the gate makes you sign in you name address and some other personal information and lets you in)

You can see Help Desk Employee here.

>w
You can't go that way.

>e
Map
You take out your cellphone and open the gps. These are the locations you can see: 
 1) Police Station towards north. 
 1) Your Hotel towards south.

>s
As you enter you Hotel Room you see 2 dark figures behind you. You hear a loud noise before falling to the ground and losing conciousness

Please press SPACE to continue.

>n
Bathroom
A boring bathroom.

* * *

>s
Hotel Room
A beautiful, well lit room with an attached bathroom.

You can see a Hotel Door, Dresser, Television, Table (on which is Laptop), Painting, Ceiling lights and Bed here.

>s
Map
You take out your cellphone and open the gps. These are the locations you can see: 
hote to south 
  Embassy  to west 
1) Police Station towards north.

>s
Hotel Room
A beautiful, well lit room with an attached bathroom.

You can see a Hotel Door, Dresser, Television, Table (on which is Laptop), Painting, Ceiling lights and Bed here.

Why are you doing this to me, Mark, Lisa where is everyone.

Please press SPACE to continue.

Day 3 
 You wake in dark place and cannot see anything. you seem to be in a corner of a room, soon your eyes adjust to the darkness and you see piled bodies all aroudn you, you try to move but your hands seem to be tied.

Unknown Place
fwefwqef

You can see Old Door, Dead Body 1, Dead Body 2 (in which is a gun), Dead Body 3, Dead Body 4, Dead Body 5, Dead Body 6, Unknown Figure 1 and Unknown Figure 2 here.

>inventory
You are carrying nothing.

>take gun
You should probably not take that

>go through Old Door
(first opening Old Door)
You see two figures talking in the hallway, they notice you as you open the door, you suddenly realize that its Karl and your friend Mark.

>talk to mark
You try to talk to mark but he doesnt respond, all you can see is a slight smile on this face which sends shivers down your spine.

>talk to karl
You think of quesitons you could ask Karl. These are the only things you could think of: 
1). Whats going on.
2). Why is Mark with you.
3). You are alive.

>ask karl about Whats going on
you mustve guessed by now, the human body is much more valuable than we think, much much more valuable, and we are jusr ordinary people who value it.

>ask karl about Why is Mark with you
Mark  and i have been business partners,...

>ask karl about You are alive
Do you know something about the Kidnappings
Youve said enough, time to die. 
 The time slows down, you watch as the bullet comes towards you. You feel the loud thump as your numb body collapses onto the cold wooden floor

Please press SPACE to continue.

* * *

>take gun
You should probably not take that

>go through door
(first opening Old Door)
You see two figures talking in the hallway, they notice you as you open the door, you suddenly realize that its Karl and your friend Mark.

* * *

>s
Karl sees you try to escape and shoots a gun at you. 
 The time slows down, you watch as the bullet comes towards you. You feel the loud thump as your numb body collapses onto the cold wooden floor

Please press SPACE to continue.

You died.

* * *

THE RED TIRADE 
 By Aakarsh Sinha

Please press SPACE to continue.

>take painting
Yup steal it all, why the hell not, right?

>take painting
You should probably not take thatYup steal it all, why the hell not, right?

* * *

>take painting
Yup steal it all, why the hell not, right?

>take ceiling lights
I could get into trouble for taking that.

>take ceiling lights
Really you sure you want to do this?

>take ceiling lights
Really you sure you want to do this?

>take ceiling lights
You should probably not take that

>take ceiling lights
Yup steal it all, why the hell not, right?

* * *

THE RED TIRADE 
 By Aakarsh Sinha

Please press SPACE to continue.

IMPORTANT:READ THIS BEFORE PLAYING THE GAME

========================================
The game doesn't require you to type in random things to try and guess how to talk to NPCs. Instead the game uses a TALK TO command. Everytime you want to have a conversation with an NPC you can just type:
Talk to name of NPC 
 
 After a list shows up, to talk to the NPC you need to type:
 Ask name of NPC about ONE OF THE SENTENCES FROM THE LIST.
====================================================

To move in the world you type: 
  N(To go north) 
 S(To go south) 
 E(To go east) 
 W(To go west) 
 
To go through doors you type: 
Go through Old Door  
 
In this game in certain situaitons you will need to combine things to make new things to be used to progress further in the game. To do that you can write:  
 Combine cholocate with paper.  
  
You can also use things by typing: 
 Use Laptop. 

Other Important Commands:
 Take
Examine
Shoot

Please press SPACE to continue.

Welcome
An Interactive Fiction
Release 1 / Serial number 180908 / Inform 7 build 6M62 (I6/v6.33 lib 6/12N) SD

Hotel Room
A beautiful, well lit room. You still cannot believe how cheap this room was. There is a huge painting of The Great Wave off Kanagawa above the bed. and a few beautiful lamps amplify the beauty of the room. All of this makes you think how happy you were a few days ago visiting a new country far away from home, stepping into an entirely new culture. But since Amy's disappearance two days ago everything has changed. You suddenly feel your heart sink and memories of Lisa come to your mind.

You can see a Hotel Door, Dresser (on which are some money, a Lamp and Folded Clothes), Television, Table (on which is Laptop), Painting, Ceiling lights and Bed here.

>take bed
Yup! Steal it all. Why the hell not, right?

>open bed
It isn't something you can open.

>s
Map
You take out your cellphone and open the gps. These are the locations you can see: 
 1) Police Station towards north. 
 2) Your Hotel towards south.

>n
Police Station
YOU ENTER THE POLICE STATION: The police station stands as a monolith in the middle of nowhere. The ominous walls that encompass the building almost evoke a sense of dread. As you enter the building you see a tiny room. You see a huge archway on one of the walls TOWARDS THE NORTH that leads to a hallway behind the front desk.

You can see Reception Counter, Paintings of Gandi, Nehru, Wall Clock, Tables, Chairs and a Receptionist here.

>s
Map
You take out your cellphone and open the gps. These are the locations you can see: 
 1) Police Station towards north. 
 2) Your Hotel towards south.

>s
Hotel Room
A beautiful, well lit room. You still cannot believe how cheap this room was. There is a huge painting of The Great Wave off Kanagawa above the bed. and a few beautiful lamps amplify the beauty of the room. All of this makes you think how happy you were a few days ago visiting a new country far away from home, stepping into an entirely new culture. But since Amy's disappearance two days ago everything has changed. You suddenly feel your heart sink and memories of Lisa come to your mind.

You can see a Hotel Door, Dresser (on which are some money, a Lamp and Folded Clothes), Television, Table (on which is Laptop), Painting, Ceiling lights and Bed here.

>take moeny
You can't see any such thing.

>take money
Really? Are you sure you want to take this?